წყლებს	წყალი	Ncnpd-
ფულებს	ფული	Ncnpd-
მძივებს	მძივი	Ncnpd-
კარებს	კარი	Ncnpd-
აზრებს	აზრი	Ncnpd-
წყლებში	წყალი	Ncnpdy
ფულებში	ფული	Ncnpdy
მძივებში	მძივი	Ncnpdy
კარებში	კარი	Ncnpdy
აზრებში	აზრი	Ncnpdy
წყლების	წყალი	Ncnpg-
ფულების	ფული	Ncnpg-
მძივების	მძივი	Ncnpg-
კარების	კარი	Ncnpg-
აზრების	აზრი	Ncnpg-
წყლებისკენ	წყალი	Ncnpgy
ფულებისკენ	ფული	Ncnpgy
მძივებისკენ	მძივი	Ncnpgy
კარებისკენ	კარი	Ncnpgy
აზრებისკენ	აზრი	Ncnpgy
წყლებით	წყალი	Ncnpi-
ფულებით	ფული	Ncnpi-
მძივებით	მძივი	Ncnpi-
კარებით	კარი	Ncnpi-
აზრებით	აზრი	Ncnpi-
წყლებიდან	წყალი	Ncnpiy
ფულებიდან	ფული	Ncnpiy
მძივებიდან	მძივი	Ncnpiy
კარებიდან	კარი	Ncnpiy
აზრებიდან	აზრი	Ncnpiy
წყლები	წყალი	Ncnpn-
ფულები	ფული	Ncnpn-
მძივები	მძივი	Ncnpn-
კარები	კარი	Ncnpn-
აზრები	აზრი	Ncnpn-
წყლებივითა	წყალი	Ncnpny
ფულებივით	ფული	Ncnpny
მძივებივით	მძივი	Ncnpny
კარებივით	კარი	Ncnpny
აზრებივით	აზრი	Ncnpny
წყლებო	წყალი	Ncnpv-
ფულებო	ფული	Ncnpv-
მძივებო	მძივი	Ncnpv-
კარებო	კარი	Ncnpv-
აზრებო	აზრი	Ncnpv-
წყალნო-მეთქი	წყალი	Ncnpvy
ფულნო-მეთქი	ფული	Ncnpvy
მძივებო-მეთქი	მძივი	Ncnpvy
კარებო-მეთქი	კარი	Ncnpvy
აზრებო-მეთქი	აზრი	Ncnpvy
წყლებად	წყალი	Ncnpw-
ფულებად	ფული	Ncnpw-
მძივებად	მძივი	Ncnpw-
კარებად	კარი	Ncnpw-
აზრებად	აზრი	Ncnpw-
წყლებამდე	წყალი	Ncnpwy
ფულებამდე	ფული	Ncnpwy
მძივებამდე	მძივი	Ncnpwy
კარებამდე	კარი	Ncnpwy
აზრებამდე	აზრი	Ncnpwy
წყლებმა	წყალი	Ncnpz-
ფულებმა	ფული	Ncnpz-
მძივებმა	მძივი	Ncnpz-
კარებმა	კარი	Ncnpz-
აზრებმა	აზრი	Ncnpz-
წყლებმაც	წყალი	Ncnpzy
ფულებმაც	ფული	Ncnpzy
აზრებმაც	მძივი	Ncnpzy
კარებმაც	კარი	Ncnpzy
აზრებმაც	აზრი	Ncnpzy
წყალს	წყალი	Ncnsd-
ფულს	ფული	Ncnsd-
მძივს	მძივი	Ncnsd-
კარს	კარი	Ncnsd-
აზრს	აზრი	Ncnsd-
წყალში	წყალი	Ncnsdy
ფულში	ფული	Ncnsdy
მძივში	მძივი	Ncnsdy
კარში	კარი	Ncnsdy
აზრში	აზრი	Ncnsdy
წყლის	წყალი	Ncnsg-
ფულის	ფული	Ncnsg-
მძივის	მძივი	Ncnsg-
კარის	კარი	Ncnsg-
აზრის	აზრი	Ncnsg-
წყლისკენ	წყალი	Ncnsgy
ფულისკენ	ფული	Ncnsgy
მძივისკენ	მძივი	Ncnsgy
კარისკენ	კარი	Ncnsgy
აზრისკენ	აზრი	Ncnsgy
წყლით	წყალი	Ncnsi-
ფულით	ფული	Ncnsi-
მძივით	მძივი	Ncnsi-
კარით	კარი	Ncnsi-
აზრით	აზრი	Ncnsi-
წყლიდან	წყალი	Ncnsiy
ფულიდან	ფული	Ncnsiy
მძივიდან	მძივი	Ncnsiy
კარიდან	კარი	Ncnsiy
აზრიდან	აზრი	Ncnsiy
წყალი	წყალი	Ncnsn-
ფული	ფული	Ncnsn-
მძივი	მძივი	Ncnsn-
კარი	კარი	Ncnsn-
აზრი	აზრი	Ncnsn-
წყალივითა	წყალი	Ncnsny
ფულივით	ფული	Ncnsny
მძივივით	მძივი	Ncnsny
კარივით	კარი	Ncnsny
აზრივით	აზრი	Ncnsny
წყალო	წყალი	Ncnsv-
ფულო	ფული	Ncnsv-
მძივო	მძივი	Ncnsv-
კარო	კარი	Ncnsv-
აზრო	აზრი	Ncnsv-
წყალო-მეთქი	წყალი	Ncnsvy
ფულო-მეთქი	ფული	Ncnsvy
მძივო-მეთქი	მძივი	Ncnsvy
კარო-მეთქი	კარი	Ncnsvy
აზრო-მეთქი	აზრი	Ncnsvy
წყლად	წყალი	Ncnsw-
ფულად	ფული	Ncnsw-
მძივად	მძივი	Ncnsw-
კარად	კარი	Ncnsw-
აზრად	აზრი	Ncnsw-
წყლამდე	წყალი	Ncnswy
ფულამდე	ფული	Ncnswy
მძივამდე	მძივი	Ncnswy
კარამდე	კარი	Ncnswy
აზრამდე	აზრი	Ncnswy
წყალმა	წყალი	Ncnsz-
ფულმა	ფული	Ncnsz-
მძივმა	მძივი	Ncnsz-
კარმა	კარი	Ncnsz-
აზრმა	აზრი	Ncnsz-
წყალმაც	წყალი	Ncnszy
ფულმაც	ფული	Ncnszy
აზრმაც	მძივი	Ncnszy
კარმაც	კარი	Ncnszy
აზრმაც	აზრი	Ncnszy
პოეტებს	პოეტი	Ncypd-
მხედრებს	მხედარი	Ncypd-
მომხმარებლებს	მომხმარებელი	Ncypd-
მასწავლებლებს	მასწავლებელი	Ncypd-
თვითმხილველებს	თვითმხილველი	Ncypd-
პოეტებში	პოეტი	Ncypdy
მხედრებში	მხედარი	Ncypdy
მომხმარებლებში	მომხმარებელი	Ncypdy
მასწავლებლებში	მასწავლებელი	Ncypdy
თვითმხილველებში	თვითმხილველი	Ncypdy
პოეტების	პოეტი	Ncypg-
მხედრების	მხედარი	Ncypg-
მომხმარებლების	მომხმარებელი	Ncypg-
მასწავლებლების	მასწავლებელი	Ncypg-
თვითმხილველების	თვითმხილველი	Ncypg-
პოეტებისკენ	პოეტი	Ncypgy
მხედრებისკენ	მხედარი	Ncypgy
მომხმარებლებისკენ	მომხმარებელი	Ncypgy
მასწავლებლებისკენ	მასწავლებელი	Ncypgy
თვითმხილველებისკენ	თვითმხილველი	Ncypgy
პოეტებით	პოეტი	Ncypi-
მხედრებით	მხედარი	Ncypi-
მომხმარებლებით	მომხმარებელი	Ncypi-
მასწავლებლებით	მასწავლებელი	Ncypi-
თვითმხილველებით	თვითმხილველი	Ncypi-
პოეტებიდან	პოეტი	Ncypiy
მხედრებიდან	მხედარი	Ncypiy
მომხმარებლებიდან	მომხმარებელი	Ncypiy
მასწავლებლებიდან	მასწავლებელი	Ncypiy
თვითმხილველებიდან	თვითმხილველი	Ncypiy
პოეტები	პოეტი	Ncypy-
მხედრები	მხედარი	Ncypy-
მომხმარებლები	მომხმარებელი	Ncypy-
მასწავლებლები	მასწავლებელი	Ncypy-
თვითმხილველები	თვითმხილველი	Ncypy-
პოეტებივითა	პოეტი	Ncypyy
მხედრებივით	მხედარი	Ncypyy
მომხმარებლებივით	მომხმარებელი	Ncypyy
მასწავლებლებივით	მასწავლებელი	Ncypyy
თვითმხილველებივით	თვითმხილველი	Ncypyy
პოეტებო	პოეტი	Ncypv-
მხედრებო	მხედარი	Ncypv-
მომხმარებლებო	მომხმარებელი	Ncypv-
მასწავლებლებო	მასწავლებელი	Ncypv-
თვითმხილველებო	თვითმხილველი	Ncypv-
პოეტნო-მეთქი	პოეტი	Ncypvy
მხედარნო-მეთქი	მხედარი	Ncypvy
მომხმარებლებო-მეთქი	მომხმარებელი	Ncypvy
მასწავლებლებო-მეთქი	მასწავლებელი	Ncypvy
თვითმხილველებო-მეთქი	თვითმხილველი	Ncypvy
პოეტებად	პოეტი	Ncypw-
მხედრებად	მხედარი	Ncypw-
მომხმარებლებად	მომხმარებელი	Ncypw-
მასწავლებლებად	მასწავლებელი	Ncypw-
თვითმხილველებად	თვითმხილველი	Ncypw-
პოეტებამდე	პოეტი	Ncypwy
მხედრებამდე	მხედარი	Ncypwy
მომხმარებლებამდე	მომხმარებელი	Ncypwy
მასწავლებლებამდე	მასწავლებელი	Ncypwy
თვითმხილველებამდე	თვითმხილველი	Ncypwy
პოეტებმა	პოეტი	Ncypz-
მხედრებმა	მხედარი	Ncypz-
მომხმარებლებმა	მომხმარებელი	Ncypz-
მასწავლებლებმა	მასწავლებელი	Ncypz-
თვითმხილველებმა	თვითმხილველი	Ncypz-
პოეტებმაც	პოეტი	Ncypzy
მხედრებმაც	მხედარი	Ncypzy
თვითმხილველებმაც	მომხმარებელი	Ncypzy
მასწავლებლებმაც	მასწავლებელი	Ncypzy
თვითმხილველებმაც	თვითმხილველი	Ncypzy
პოეტს	პოეტი	Ncysd-
მხედარს	მხედარი	Ncysd-
მომხმარებელს	მომხმარებელი	Ncysd-
მასწავლებელს	მასწავლებელი	Ncysd-
თვითმხილველს	თვითმხილველი	Ncysd-
პოეტში	პოეტი	Ncysdy
მხედარში	მხედარი	Ncysdy
მომხმარებელში	მომხმარებელი	Ncysdy
მასწავლებელში	მასწავლებელი	Ncysdy
თვითმხილველში	თვითმხილველი	Ncysdy
წყლის	პოეტი	Ncysg-
მხედრის	მხედარი	Ncysg-
მომხმარებლის	მომხმარებელი	Ncysg-
მასწავლებლის	მასწავლებელი	Ncysg-
თვითმხილველის	თვითმხილველი	Ncysg-
პოეტისკენ	პოეტი	Ncysgy
მხედრისკენ	მხედარი	Ncysgy
მომხმარებლისკენ	მომხმარებელი	Ncysgy
მასწავლებლისკენ	მასწავლებელი	Ncysgy
თვითმხილველისკენ	თვითმხილველი	Ncysgy
პოეტით	პოეტი	Ncysi-
მხედრით	მხედარი	Ncysi-
მომხმარებლით	მომხმარებელი	Ncysi-
მასწავლებლით	მასწავლებელი	Ncysi-
თვითმხილველით	თვითმხილველი	Ncysi-
პოეტიდან	პოეტი	Ncysiy
მხედრიდან	მხედარი	Ncysiy
მომხმარებლიდან	მომხმარებელი	Ncysiy
მასწავლებლიდან	მასწავლებელი	Ncysiy
თვითმხილველიდან	თვითმხილველი	Ncysiy
პოეტი	პოეტი	Ncysy-
მხედარი	მხედარი	Ncysy-
მომხმარებელი	მომხმარებელი	Ncysy-
მასწავლებელი	მასწავლებელი	Ncysy-
თვითმხილველი	თვითმხილველი	Ncysy-
პოეტივითა	პოეტი	Ncysyy
მხედრივით	მხედარი	Ncysyy
მომხმარებლივით	მომხმარებელი	Ncysyy
მასწავლებლივით	მასწავლებელი	Ncysyy
თვითმხილველივით	თვითმხილველი	Ncysyy
პოეტო	პოეტი	Ncysv-
მხედარო	მხედარი	Ncysv-
მომხმარებელო	მომხმარებელი	Ncysv-
მასწავლებელო	მასწავლებელი	Ncysv-
თვითმხილველო	თვითმხილველი	Ncysv-
პოეტო-მეთქი	პოეტი	Ncysvy
მხედარო-მეთქი	მხედარი	Ncysvy
მომხმარებელო-მეთქი	მომხმარებელი	Ncysvy
მასწავლებელო-მეთქი	მასწავლებელი	Ncysvy
თვითმხილველო-მეთქი	თვითმხილველი	Ncysvy
პოეტად	პოეტი	Ncysw-
მხედრად	მხედარი	Ncysw-
მომხმარებლად	მომხმარებელი	Ncysw-
მასწავლებლად	მასწავლებელი	Ncysw-
თვითმხილველად	თვითმხილველი	Ncysw-
პოეტამდე	პოეტი	Ncyswy
მხედრამდე	მხედარი	Ncyswy
მომხმარებლამდე	მომხმარებელი	Ncyswy
მასწავლებლამდე	მასწავლებელი	Ncyswy
თვითმხილველამდე	თვითმხილველი	Ncyswy
პოეტმა	პოეტი	Ncysz-
მხედარმა	მხედარი	Ncysz-
მომხმარებელმა	მომხმარებელი	Ncysz-
მასწავლებელმა	მასწავლებელი	Ncysz-
თვითმხილველმა	თვითმხილველი	Ncysz-
პოეტმაც	პოეტი	Ncyszy
მხედარმაც	მხედარი	Ncyszy
თვითმხილველმაც	მომხმარებელი	Ncyszy
მასწავლებელმაც	მასწავლებელი	Ncyszy
თვითმხილველმაც	თვითმხილველი	Ncyszy
წყალს	არაგვი	Npnsd-
ფულს	მესხეთი	Npnsd-
მძივს	მცხეთა	Npnsd-
კარს	საქართველო	Npnsd-
აზრს	აღმოსავლეთი	Npnsd-
წყალში	არაგვი	Npnsdy
ფულში	მესხეთი	Npnsdy
მძივში	მცხეთა	Npnsdy
კარში	საქართველო	Npnsdy
აზრში	აღმოსავლეთი	Npnsdy
წყლის	არაგვი	Npnsg-
ფულის	მესხეთი	Npnsg-
მძივის	მცხეთა	Npnsg-
კარის	საქართველო	Npnsg-
აზრის	აღმოსავლეთი	Npnsg-
წყლისკენ	არაგვი	Npnsgy
ფულისკენ	მესხეთი	Npnsgy
მძივისკენ	მცხეთა	Npnsgy
კარისკენ	საქართველო	Npnsgy
აზრისკენ	აღმოსავლეთი	Npnsgy
წყლით	არაგვი	Npnsi-
ფულით	მესხეთი	Npnsi-
მძივით	მცხეთა	Npnsi-
კარით	საქართველო	Npnsi-
აზრით	აღმოსავლეთი	Npnsi-
წყლიდან	არაგვი	Npnsiy
ფულიდან	მესხეთი	Npnsiy
მძივიდან	მცხეთა	Npnsiy
კარიდან	საქართველო	Npnsiy
აზრიდან	აღმოსავლეთი	Npnsiy
არაგვი	არაგვი	Npnsn-
მესხეთი	მესხეთი	Npnsn-
მცხეთა	მცხეთა	Npnsn-
საქართველო	საქართველო	Npnsn-
აღმოსავლეთი	აღმოსავლეთი	Npnsn-
არაგვივითა	არაგვი	Npnsny
მესხეთივით	მესხეთი	Npnsny
მცხეთავით	მცხეთა	Npnsny
საქართველოვით	საქართველო	Npnsny
აღმოსავლეთივით	აღმოსავლეთი	Npnsny
არაგვო	არაგვი	Npnsv-
მესხეთო	მესხეთი	Npnsv-
მცხეთავ	მცხეთა	Npnsv-
საქართველოვ	საქართველო	Npnsv-
აღმოსავლეთო	აღმოსავლეთი	Npnsv-
არაგვო-მეთქი	არაგვი	Npnsvy
მესხეთო-მეთქი	მესხეთი	Npnsvy
მცხეთავ-მეთქი	მცხეთა	Npnsvy
საქართველოვ-მეთქი	საქართველო	Npnsvy
აღმოსავლეთო-მეთქი	აღმოსავლეთი	Npnsvy
არაგვად	არაგვი	Npnsw-
მესხეთად	მესხეთი	Npnsw-
მცხეთად	მცხეთა	Npnsw-
საქართველოდ	საქართველო	Npnsw-
აღმოსავლეთად	აღმოსავლეთი	Npnsw-
არაგვამდე	არაგვი	Npnswy
მესხეთამდე	მესხეთი	Npnswy
მცხეთამდე	მცხეთა	Npnswy
საქართველომდე	საქართველო	Npnswy
აღმოსავლეთამდე	აღმოსავლეთი	Npnswy
არაგვმა	არაგვი	Npnsz-
მესხეთმა	მესხეთი	Npnsz-
მცხეთა	მცხეთა	Npnsz-
საქართველომდე	საქართველო	Npnsz-
აღმოსავლეთმა	აღმოსავლეთი	Npnsz-
არაგვმაც	არაგვი	Npnszy
მესხეთმაც	მესხეთი	Npnszy
მცხეთამაც	მცხეთა	Npnszy
საქართველომაც	საქართველო	Npnszy
აღმოსავლეთმაც	აღმოსავლეთი	Npnszy
წერეთლებს	წერეთელი	Npypd-
გურამიშვილებს	გურამიშვილი	Npypd-
გელაშვილებს	გელაშვილი	Npypd-
ქორიძეებს	ქორიძე	Npypd-
შანიძეებს	შანიძე	Npypd-
წერეთლებში	წერეთელი	Npypdy
გურამიშვილებში	გურამიშვილი	Npypdy
გელაშვილებში	გელაშვილი	Npypdy
ქორიძეებში	ქორიძე	Npypdy
შანიძეებში	შანიძე	Npypdy
წერეთლების	წერეთელი	Npypg-
გურამიშვილების	გურამიშვილი	Npypg-
გელაშვილების	გელაშვილი	Npypg-
ქორიძეების	ქორიძე	Npypg-
შანიძეების	შანიძე	Npypg-
წერეთლებისკენ	წერეთელი	Npypgy
გურამიშვილებისკენ	გურამიშვილი	Npypgy
გელაშვილებისკენ	გელაშვილი	Npypgy
ქორიძეებისკენ	ქორიძე	Npypgy
შანიძეებისკენ	შანიძე	Npypgy
წერეთლებით	წერეთელი	Npypi-
გურამიშვილებით	გურამიშვილი	Npypi-
გელაშვილებით	გელაშვილი	Npypi-
ქორიძეებით	ქორიძე	Npypi-
შანიძეებით	შანიძე	Npypi-
წერეთლებიდან	წერეთელი	Npypiy
გურამიშვილებიდან	გურამიშვილი	Npypiy
გელაშვილებიდან	გელაშვილი	Npypiy
ქორიძეებიდან	ქორიძე	Npypiy
შანიძეებიდან	შანიძე	Npypiy
წერეთლები	წერეთელი	Npypy-
გურამიშვილები	გურამიშვილი	Npypy-
გელაშვილები	გელაშვილი	Npypy-
ქორიძეები	ქორიძე	Npypy-
შანიძეები	შანიძე	Npypy-
წერეთლებივითა	წერეთელი	Npypyy
გურამიშვილებივით	გურამიშვილი	Npypyy
გელაშვილებივით	გელაშვილი	Npypyy
ქორიძეებივით	ქორიძე	Npypyy
შანიძეებივით	შანიძე	Npypyy
წერეთლებო	წერეთელი	Npypv-
გურამიშვილებო	გურამიშვილი	Npypv-
გელაშვილებო	გელაშვილი	Npypv-
ქორიძეებო	ქორიძე	Npypv-
შანიძეებო	შანიძე	Npypv-
წერეთელნო-მეთქი	წერეთელი	Npypvy
მხედარნო-მეთქი	გურამიშვილი	Npypvy
გელაშვილებო-მეთქი	გელაშვილი	Npypvy
ქორიძეებო-მეთქი	ქორიძე	Npypvy
შანიძეებო-მეთქი	შანიძე	Npypvy
წერეთლებად	წერეთელი	Npypw-
გურამიშვილებად	გურამიშვილი	Npypw-
გელაშვილებად	გელაშვილი	Npypw-
ქორიძეებად	ქორიძე	Npypw-
შანიძეებად	შანიძე	Npypw-
წერეთლებამდე	წერეთელი	Npypwy
გურამიშვილებამდე	გურამიშვილი	Npypwy
გელაშვილებამდე	გელაშვილი	Npypwy
ქორიძეებამდე	ქორიძე	Npypwy
შანიძეებამდე	შანიძე	Npypwy
წერეთლებმა	წერეთელი	Npypz-
გურამიშვილებმა	გურამიშვილი	Npypz-
გელაშვილებმა	გელაშვილი	Npypz-
ქორიძეებმა	ქორიძე	Npypz-
შანიძეებმა	შანიძე	Npypz-
წერეთლებმაც	წერეთელი	Npypzy
გურამიშვილებმაც	გურამიშვილი	Npypzy
შანიძეებმაც	გელაშვილი	Npypzy
ქორიძეებმაც	ქორიძე	Npypzy
შანიძეებმაც	შანიძე	Npypzy
იოანეს	იოანე	Npysd-
დავითს	დავითი	Npysd-
ნელის	ნელი	Npysd-
წერეთელს	წერეთელი	Npysd-
გურამიშვილს	გურამიშვილი	Npysd-
იოანესთან	იოანე	Npysdy
დავითთან	დავითი	Npysdy
ნელისთან	ნელი	Npysdy
წერეთელთან	წერეთელი	Npysdy
გურამიშვილთან	გურამიშვილი	Npysdy
იოანის	იოანე	Npysg-
დავითის	დავითი	Npysg-
ნელის	ნელი	Npysg-
წერეთლის	წერეთელი	Npysg-
გურამიშვილის	გურამიშვილი	Npysg-
იოანესკენ	იოანე	Npysgy
დავითისკენ	დავითი	Npysgy
ნელისკენ	ნელი	Npysgy
წერეთლისკენ	წერეთელი	Npysgy
გურამიშვილისკენ	გურამიშვილი	Npysgy
იოანეთ	იოანე	Npysi-
დავითით	დავითი	Npysi-
ნელით	ნელი	Npysi-
წერეთლით	წერეთელი	Npysi-
გურამიშვილით	გურამიშვილი	Npysi-
იოანეთურთ	იოანე	Npysiy
დავითითურთ	დავითი	Npysiy
ნელითურთ	ნელი	Npysiy
წერეთლითურთ	წერეთელი	Npysiy
გურამიშვილითურთ	გურამიშვილი	Npysiy
იოანე	იოანე	Npysy-
დავითი	დავითი	Npysy-
ნელი	ნელი	Npysy-
წერეთელი	წერეთელი	Npysy-
გურამიშვილი	გურამიშვილი	Npysy-
იოანეივითა	იოანე	Npysyy
დავითივით	დავითი	Npysyy
ნელივით	ნელი	Npysyy
წერეთლივით	წერეთელი	Npysyy
გურამიშვილივით	გურამიშვილი	Npysyy
იოანევ	იოანე	Npysv-
დავითო	დავითი	Npysv-
ნელი	ნელი	Npysv-
წერეთელო	წერეთელი	Npysv-
გურამიშვილო	გურამიშვილი	Npysv-
იოანეო-მეთქი	იოანე	Npysvy
დავითო-მეთქი	დავითი	Npysvy
ნელი-მეთქი	ნელი	Npysvy
წერეთელო-მეთქი	წერეთელი	Npysvy
გურამიშვილო-მეთქი	გურამიშვილი	Npysvy
იოანად	იოანე	Npysw-
დავითად	დავითი	Npysw-
ნელად	ნელი	Npysw-
წერეთლად	წერეთელი	Npysw-
გურამიშვილად	გურამიშვილი	Npysw-
იოანემდე	იოანე	Npyswy
დავითამდე	დავითი	Npyswy
ნელამდე	ნელი	Npyswy
წერეთლამდე	წერეთელი	Npyswy
გურამიშვილამდე	გურამიშვილი	Npyswy
იოანემ	იოანე	Npysz-
დავითმა	დავითი	Npysz-
ნელიმ	ნელი	Npysz-
წერეთელმა	წერეთელი	Npysz-
გურამიშვილმა	გურამიშვილი	Npysz-
იოანემაც	იოანე	Npyszy
დავითმაც	დავითი	Npyszy
ნელიმაც	ნელი	Npyszy
წერეთელმაც	წერეთელი	Npyszy
გურამიშვილმაც	გურამიშვილი	Npyszy
წერას	წერა	Ncnsd-
კითხვას	კითხვა	Ncnsd-
ხატვას	ხატვა	Ncnsd-
საქმიანობას	საქმიანობა	Ncnsd-
გამოყენებას	გამოყენება	Ncnsd-
წერაში	წერა	Ncnsdy
კითხვაში	კითხვა	Ncnsdy
ხატვაში	ხატვა	Ncnsdy
საქმიანობში	საქმიანობა	Ncnsdy
გამოყენებაში	გამოყენება	Ncnsdy
წერის	წერა	Ncnsg-
კითხვის	კითხვა	Ncnsg-
ხატვის	ხატვა	Ncnsg-
საქმიანობის	საქმიანობა	Ncnsg-
გამოყენების	გამოყენება	Ncnsg-
წერისკენ	წერა	Ncnsgy
კითხვისკენ	კითხვა	Ncnsgy
ხატვისკენ	ხატვა	Ncnsgy
საქმიანობისკენ	საქმიანობა	Ncnsgy
გამოყენებისკენ	გამოყენება	Ncnsgy
წერით	წერა	Ncnsi-
კითხვით	კითხვა	Ncnsi-
ხატვით	ხატვა	Ncnsi-
საქმიანობით	საქმიანობა	Ncnsi-
გამოყენებით	გამოყენება	Ncnsi-
წყლიდან	წერა	Ncnsiy
კითხვიდან	კითხვა	Ncnsiy
ხატვიდან	ხატვა	Ncnsiy
საქმიანობიდან	საქმიანობა	Ncnsiy
გამოყენებიდან	გამოყენება	Ncnsiy
წერა	წერა	Ncnsn-
კითხვა	კითხვა	Ncnsn-
ხატვა	ხატვა	Ncnsn-
საქმიანობა	საქმიანობა	Ncnsn-
გამოყენებაი	გამოყენება	Ncnsn-
წერივით	წერა	Ncnsny
კითხვივით	კითხვა	Ncnsny
ხატვაც	ხატვა	Ncnsny
საქმიანობაც	საქმიანობა	Ncnsny
გამოყენებაც	გამოყენება	Ncnsny
წერად	წერა	Ncnsw-
კითხვად	კითხვა	Ncnsw-
ხატვად	ხატვა	Ncnsw-
საქმიანობად	საქმიანობა	Ncnsw-
გამოყენებაად	გამოყენება	Ncnsw-
წერამდე	წერა	Ncnswy
კითხვამდე	კითხვა	Ncnswy
ხატვამდე	ხატვა	Ncnswy
საქმიანობამდე	საქმიანობა	Ncnswy
გამოყენებამდე	გამოყენება	Ncnswy
წერამ	წერა	Ncnsz-
კითხვამ	კითხვა	Ncnsz-
ხატვამ	ხატვა	Ncnsz-
საქმიანობამ	საქმიანობა	Ncnsz-
გამოყენებამ	გამოყენება	Ncnsz-
წერამაც	წერა	Ncnszy
კითხვამაც	კითხვა	Ncnszy
ხატვამაც	ხატვა	Ncnszy
საქმიანობმაც	საქმიანობა	Ncnszy
გამოყენებამაც	გამოყენება	Ncnszy
