vinzha	vinči	Afcfsn	1
vénci	vilek	Afcmsn	3
staraisi	stär	Afcmsn	3
mlaisi	mlad	Afcmsn	3
lípce	lip	Afcnsa--n	1
bujše	bujši	Afcnsn	1
ver	vër	Afp	3
kontent	kontent	Afp	3
cert	čert	Afp	3
šolbaške	solbaški	Afpfda	1
Sveti	svet	Afpfpa	3
druhe	drügi	Afpfpa	3
drüge	drügi	Afpfpa	3
sadgne	zadnji	Afpfpn	3
furlanske	furlanski	Afpfpn	3
dobre	dobar	Afpfpn	3
sweto	svet	Afpfsa	3
Sveto	svet	Afpfsa	3
Dolorano	dolorän	Afpfsa	3
slabo	släb	Afpfsan	1
Sveti	svet	Afpfsd	2
Romanchi	romanjski	Afpfsd	2
Svete	svet	Afpfsg	2
shurigne	zurinji	Afpfsg	2
sveto	svet	Afpfsi	3
samo	sam	Afpfsi	3
merzlo	zmärzal	Afpfsi	3
Villichj	vilek	Afpfsl	3
tesni	tesni	Afpfsl	3
tesniey	tesni	Afpfsl	3
Sveta	svet	Afpfsn	3
punczaha	punčak	Afpfsn	3
Dolorozna	dolorozan	Afpfsn	3
tožna	tožan	Afpmdn	1
sve	swöj	Afpmpa	3
strasne	štrašan	Afpmpa	3
martve	märtuw	Afpmpa	3
porazhanin	poračan	Afpmpd	2
dobrim	dobar	Afpmpd	2
zbranih	zbrän	Afpmpg	3
Svetih	sveti	Afpmpg	3
svetih	svet	Afpmpg	3
saplaçhiní	zaplaćën	Afpmpgn	1
gardimi	gärd	Afpmpi	1
Svetih	svet	Afpmpl	1
veliki	vilek	Afpmpn	3
toshni	tožan	Afpmpn	3
legri	legro	Afpmpn	3
näšnji	näšnji	Afpmsa--n	2
dalesgni	dalëčnji	Afpmsa--n	2
sladkega	sladak	Afpmsa--y	3
kunvirtínaga	kunvirten	Afpmsa--y	3
blishgnaha	blïžnji	Afpmsa--y	3
dobar	dobar	Afpmsan-n	1
shihnani	žignan	Afpmsay-n	1
visachimù	visök	Afpmsd	3
druhomu	drügi	Afpmsd	3
druhemu	drügi	Afpmsd	3
swetaha	svet	Afpmsg	2
Svetaha	svet	Afpmsg	2
sam	sam	Afpmsnn	3
oblejan	oblajän	Afpmsnn	3
moćan	möćan	Afpmsnn	3
sami	sam	Afpmsny	3
Rozajanski	rozajanski	Afpmsny	3
delečni	dalëčnji	Afpmsny	3
smilne	smïlan	Afpnpa	1
sughimi	süh	Afpnpi	1
túlstaga	tulst	Afpnsa--y	2
tulstaga	tulst	Afpnsa--y	2
niškë	niški	Afpnsan-n	3
malu	mäl	Afpnsan-n	3
furlanskë	furlanski	Afpnsan-n	3
tulste	tulst	Afpnsay-n	2
dobre	dobar	Afpnsay-n	2
húdega	hüd	Afpnsg	3
hudaha	hüd	Afpnsg	3
chrivaha	krïw	Afpnsg	3
tardim	tärd	Afpnsi	1
rozajanskin	rozajanski	Afpnsl	2
Chrishtianschin	krištijanski	Afpnsl	2
tosno	tožan	Afpnsnn	3
sveti	svet	Afpnsnn	3
löpu	lip	Afpnsnn	3
Svete	svet	Afpnsny	1
Santiſsim	šantišim	Afs	1
Santiſsima	šantišim	Afsfsn	3
Santissima	šantišim	Afsfsn	3
Santiſshima	šantišim	Afsfsn	3
najlipsi	lip	Afsmsa--n	1
tarnouo	tärnuw	Aopfsi	1
Bohovij	böguw	Aopfsl	2
Bohavei	böguw	Aopfsl	2
nebeška	nabëški	Aopfsn	3
Jurinawa	jürinuw	Aopfsn	3
Jesusoua	jëžušuw	Aopfsn	3
Ježušova	jëžušuw	Aopmdn	1
Bohove	böguw	Aopmpa	1
Bohovih	böguw	Aopmpg	2
bögavi	böguw	Aopmpg	2
Bohovih	böguw	Aopmpl	1
wsakiedennie	wsakidinji	Aopmsa--n	3
uvsachidigni	wsakidinji	Aopmsa--n	3
ussáke_dögne	wsakidinji	Aopmsa--n	3
božjega	böžji	Aopmsa--y	1
Bohouv	böguw	Aopmsan-n	1
Nazarenskaha	nazarenski	Aopmsg	2
Bohovaha	böguw	Aopmsg	2
Bohuvin	böguw	Aopmsl	2
Bohovin	böguw	Aopmsl	2
Boshij	böžji	Aopmsny	1
Erove	jëruw	Aopnsny	1
prit_nikoj	pridniköj	Ccc	1
tácui	takoj	Ccs	3
anu	anu	Ccs	3
ano	anu	Ccs	3
sauvocha	zawojoka	Csc	3
sa_ito_kir	zajtökir	Csc	3
mabej	mabej	Csc	3
k	ka	Css	3
k’	ka	Css	3
kir	kir	Css	3
Oh	ö	I	3
oh	ö	I	3
Giò	ǵö	I	3
5	pet	Mc---d	3
32	trïstinudwa	Mc---d	3
12	dwanijst	Mc---d	3
starkrat_duísti_anu_dévatnist	štirkratdwistinudëvatnist	Mc-p-l	3
šesterdov	šastardu	Mc-p-l	3
Sedan	sëdan	Mc-p-l	3
treh	trïji	Mc-pgl	1
treh	trïji	Mc-pll	1
dvi	dwa	Mcfdal	1
tri	trïji	Mcfpal	1
trì	trïji	Mcfpnl	3
tri	trïji	Mcfpnl	3
shtiri	štirji	Mcfpnl	3
dnó	dän	Mcfsal	1
dnej	dän	Mcfsdl	1
nò	dän	Mcfsil	1
dnej	dän	Mcfsll	1
dna	dän	Mcfsnl	1
dua	dwa	Mcmdal	1
dua	dwa	Mcmdnl	1
tri	trïji	Mcmpnl	2
trij	trïji	Mcmpnl	2
noga	dän	Mcmsal---y	2
dnohà	dän	Mcmsal---y	2
dan	dän	Mcmsnl	1
sehont	sagont	Mo---l	2
sehond	sagont	Mo---l	2
pärvih	pärvi	Mofpgl	1
parve	pärvi	Mofsgl	1
tretgna	trëtnji	Mofsnl	3
prwa	pärvi	Mofsnl	3
paruva	pärvi	Mofsnl	3
tretni	trëtnji	Momsal---n	2
tretgni	trëtnji	Momsal---n	2
tretnji	trëtnji	Momsnl	3
parvi	pärvi	Momsnl	3
parve	pärvi	Momsnl	3
zanè	žanä	Ncfda	1
ráme	rama	Ncfpa	3
dobrute	dubruta	Ncfpa	3
dikle	dikla	Ncfpa	3
sulzí	sulza	Ncfpg	3
šćarì	hćï	Ncfpg	3
Persun	parsuna	Ncfpg	3
shanami	žanä	Ncfpi	3
Persunami	parsuna	Ncfpi	3
kitinami	këtina	Ncfpi	3
persunah	parsuna	Ncfpl	2
besideh	bisida	Ncfpl	2
reči	rič	Ncfpn	3
munije	münija	Ncfpn	3
costi	kust	Ncfpn	3
oro	ora	Ncfsa	3
nadejo	nadëja	Ncfsa	3
fiesto	fjëšta	Ncfsa	3
hisi	hïša	Ncfsd	3
fameje	fameja	Ncfsd	3
dušici	dušïca	Ncfsd	3
smarti	smärt	Ncfsg	3
Oshtie	oštja	Ncfsg	3
hisa	hïša	Ncfsg	3
wodo	wöda	Ncfsi	3
virtudijo	virtud	Ncfsi	3
rabio	rabja	Ncfsi	3
zimièu	zëmja	Ncfsl	3
teraze	teraca	Ncfsl	3
hrazij	gračja	Ncfsl	3
volontát	volontad	Ncfsn	3
fameja	fameja	Ncfsn	3
dikla	dikla	Ncfsn	3
Qutri	kwatri	Ncm	1
sinu	sïn	Ncmda	1
Misteriha	mišterih	Ncmdn	2
discépula	dišepul	Ncmdn	2
ospodine	guspuden	Ncmpa	3
dúlg’he	dulg	Ncmpa	3
dialëte	dijalët	Ncmpa	3
inimigen	inimïg	Ncmpd	3
dužnikaên	dužnïk	Ncmpd	3
dulsnichen	dužnïk	Ncmpd	3
potečajov	potečaj	Ncmpg	3
dní	din	Ncmpg	3
becew	beč	Ncmpg	3
judmi	jüdi	Ncmpi	3
istriki	štrïk	Ncmpi	3
hriſsi	grih	Ncmpi	3
tromentih	torment	Ncmpl	3
Sacraminteh	srament	Ncmpl	3
Comandatmiteh	komandament	Ncmpl	3
sinuvi	sïn	Ncmpn	3
romoni	romon	Ncmpn	3
grisniki	grišnik	Ncmpn	3
spasima	spasim	Ncms	1
pírsten	pärstën	Ncmsa--n	3
par	par	Ncmsa--n	3
kruck	kroh	Ncmsa--n	3
sina	sïn	Ncmsa--y	3
faméja	famëj	Ncmsa--y	3
era	jëru	Ncmsa--y	3
uçhí	oćä	Ncmsd	3
hrodu	hrod	Ncmsd	3
Bohù	bug	Ncmsd	3
žuotá	žwöt	Ncmsg	3
timpa	temp	Ncmsg	3
časa	čäs	Ncmsg	3
ospodinon	guspuden	Ncmsi	3
kričofižon	kričofïž	Ncmsi	3
Bohon	bug	Ncmsi	3
timpu	temp	Ncmsl	3
shvote	žwöt	Ncmsl	3
Paravishe	paravïž	Ncmsl	3
sin	sïn	Ncmsn	3
Ogia	oćä	Ncmsn	3
delavec	dëlavac	Ncmsn	3
pisma	pïsmu	Ncnpa	3
lita	lëtu	Ncnpa	3
colina	kolënu	Ncnpa	3
očú	öku	Ncnpg	3
lít	lëtu	Ncnpg	3
lit	lëtu	Ncnpg	3
ozhmi	öku	Ncnpi	1
pismeh	pïsmu	Ncnpl	3
mestagh	mëstu	Ncnpl	3
dileh	dëlu	Ncnpl	3
oči	öku	Ncnpn	1
ublicílu	ubličïlu	Ncnsa--n	3
nöbbe	nëbë	Ncnsa--n	3
jajcè	jajcë	Ncnsa--n	3
taléta	tale	Ncnsa--y	2
taleta	tale	Ncnsa--y	2
nebu	nëbë	Ncnsd	1
sardca	särcë	Ncnsg	3
Nebba	nëbë	Ncnsg	3
Neba	nëbë	Ncnsg	3
mysom	misu	Ncnsi	3
mison	misu	Ncnsi	3
imenom	jïmë	Ncnsi	3
nöbbe	nëbë	Ncnsl	3
nebe	nëbë	Ncnsl	3
Nebbe	nëbë	Ncnsl	3
imme	jïmë	Ncnsn	3
ime	jïmë	Ncnsn	3
delo	dëlu	Ncnsn	3
Mario	marïja	Npfsa	2
Elisabeto	elizabeta	Npfsa	2
Rezije	rezija	Npfsg	3
Marie	marïja	Npfsg	3
Eve	eva	Npfsg	3
Reziji	rezija	Npfsl	3
Rezije	rezija	Npfsl	3
Ravanci	ravanca	Npfsl	3
Marija	marïja	Npfsn	2
Maria	marïja	Npfsn	2
Kalvarii	kalvarij	Npm	3
Giesù	ǵežu	Npm	3
Calvarj	kalvarij	Npm	3
Rim	rim	Npmsa--n	3
Kalvorih	kalvarih	Npmsa--n	3
Jeruzalem	jeruzalem	Npmsa--n	3
Jezuša	jëžuš	Npmsa--y	3
Crishtusha	krïštuš	Npmsa--y	3
Christusa	krïštuš	Npmsa--y	3
Simeunu	šimeun	Npmsd	3
Kristušu	krïštuš	Npmsd	3
Kalvariu	kalvarih	Npmsd	3
Jesusa	jëžuš	Npmsg	3
Jeruzalima	jeruzalem	Npmsg	3
Crishtusha	krïštuš	Npmsg	3
Kristušon	krïštuš	Npmsi	3
Dapiton	dapit	Npmsi	3
Christusam	krïštuš	Npmsi	3
Vïdnë	vïdan	Npmsl	3
Rime	rim	Npmsl	3
Jeruzalimu	jeruzalem	Npmsl	3
Jesus	jëžuš	Npmsn	3
jesus	jëžuš	Npmsn	3
Emaus	emaus	Npmsn	3
te	iti	Pd-fpa----a	1
te	iti	Pd-fpg----a	2
seh	isi	Pd-fpg----a	2
semi	isi	Pd-fpi----a	1
te	iti	Pd-fpn----a	3
Sè	isi	Pd-fpn----a	3
ise	isi	Pd-fpn----a	3
ito	iti	Pd-fsa----a	3
isó	isi	Pd-fsa----a	3
iso	isi	Pd-fsa----a	3
ti	iti	Pd-fsl----a	1
isà	isi	Pd-fsn----a	2
isa	isi	Pd-fsn----a	2
Isa	isi	Pd-fsn----n	1
sema	isi	Pd-mdi----n	1
isè	isi	Pd-mpa----a	1
ite	iti	Pd-mpa----n	1
itën	iti	Pd-mpd----n	1
si	isi	Pd-mpn----a	1
Ti	iti	Pd-mpn----n	2
ti	iti	Pd-mpn----n	2
tè	iti	Pd-msa----a-n	3
ite	iti	Pd-msa----a-n	3
etej	iti	Pd-msa----a-n	3
iti	iti	Pd-msa----n-n	2
ite	iti	Pd-msa----n-n	2
itoga	iti	Pd-msg----a	1
itin	iti	Pd-msl----a	2
itim	iti	Pd-msl----a	2
isi	isi	Pd-msn----a	3
isè	isi	Pd-msn----a	3
ise	isi	Pd-msn----a	3
Se	isi	Pd-msn----n	2
iti	iti	Pd-msn----n	2
Itè	iti	Pd-npa----a	1
tih	iti	Pd-npl----a	1
tò	iti	Pd-nsa----a-n	3
take	taki	Pd-nsa----a-n	3
isó	isi	Pd-nsa----a-n	3
ito	iti	Pd-nsa----n-n	2
isó	isi	Pd-nsa----n-n	2
tagha	iti	Pd-nsg----a	1
tega	iti	Pd-nsg----n	2
itoha	iti	Pd-nsg----n	2
to	iti	Pd-nsn----n	3
Iso	isi	Pd-nsn----n	3
iso	isi	Pd-nsn----n	3
ishtes	ištës	Pg--------a	1
vse	väs	Pg-fpa----a	3
ussé	väs	Pg-fpa----a	3
use	väs	Pg-fpa----a	3
useh	väs	Pg-fpl----a	1
uvsè	väs	Pg-fpn----a	3
use	väs	Pg-fpn----a	3
nenke	nenki	Pg-fpn----a	3
wso	väs	Pg-fsa----a	3
uso	väs	Pg-fsa----a	3
usako	wsak	Pg-fsa----a	3
vse	väs	Pg-fsg----a	1
uvsacho	wsak	Pg-fsi----a	2
uso	väs	Pg-fsi----a	2
uvsachi	wsak	Pg-fsl----a	1
usaki	wsak	Pg-fsl----n	1
uvsà	väs	Pg-fsn----a	1
usacha	wsak	Pg-fsn----n	1
uvse	väs	Pg-mpa----a	1
Vsem	väs	Pg-mpd----a	1
vsih	väs	Pg-mpg----a	2
vseh	väs	Pg-mpg----a	2
usih	väs	Pg-mpg----n	1
usemi	väs	Pg-mpi----a	1
ussi	väs	Pg-mpn----a	3
use	väs	Pg-mpn----a	3
sami	sam	Pg-mpn----a	3
Usi	väs	Pg-mpn----n	2
usi	väs	Pg-mpn----n	2
ves	väs	Pg-msa----a-n	1
sam_ha	sam	Pg-msa----a-y	3
samega	sam	Pg-msa----a-y	3
samaha	sam	Pg-msa----a-y	3
usaki	wsak	Pg-msa----ayn	1
uvsen	väs	Pg-msl----a	2
usachin	wsak	Pg-msl----a	2
wsak	wsak	Pg-msn----an	3
Uas	väs	Pg-msn----an	3
san	sam	Pg-msn----an	3
sam	sam	Pg-msn----nn	1
useh	väs	Pg-npl----a	1
vusè	väs	Pg-nsa----a-n	3
vse	väs	Pg-nsa----a-n	3
Uvsè	väs	Pg-nsa----a-n	3
wsie	väs	Pg-nsa----n-n	3
uvsè	väs	Pg-nsa----n-n	3
use	väs	Pg-nsa----n-n	3
usiha	väs	Pg-nsg----a	1
takaha	itak	Pg-nsg----n	1
usim	väs	Pg-nsi----a	2
sarzam	särcë	Pg-nsi----a	2
vuaschin	wsak	Pg-nsl----a	2
uvsachin	wsak	Pg-nsl----a	2
ussé	väs	Pg-nsn----a	2
usse	väs	Pg-nsn----a	2
Use	väs	Pg-nsn----n	2
use	väs	Pg-nsn----n	2
kej	kej	Pi---a----n	1
chira	kiri	Pi-fsn----n	1
cach	kak	Pi-msa----a	1
dnumu	dän	Pi-msd----n	1
kiri	kiri	Pi-msn----a	1
dan	dän	Pi-msn----n	1
kako	kak	Pi-nsa----ann	1
naju	mïdwa	Pp1-da--n-n	1
nama	mïdwa	Pp1-dd--n-n	1
naju	mïdwa	Pp1-dl--n-n	1
nas	mï	Pp1-pa--b-n	1
nas	mï	Pp1-pa--n-n	1
nass	mï	Pp1-pa--y-n	2
nas	mï	Pp1-pa--y-n	2
nan	mï	Pp1-pd--n-n	3
nam	mï	Pp1-pd--n-n	3
naêm	mï	Pp1-pd--n-n	3
nan	mï	Pp1-pd--y-n	1
nami	mï	Pp1-pi--n-n	1
my	mï	Pp1-pn--n-n	2
mi	mï	Pp1-pn--n-n	2
mi	mï	Pp1-pn--y-n	1
me	jä	Pp1-sa--b-n	1
mlè	jä	Pp1-sa--n-n	1
me	jä	Pp1-sa--y-n	2
ma	jä	Pp1-sa--y-n	2
mlé	jä	Pp1-sd--n-n	1
mi	jä	Pp1-sd--y-n	1
mle	jä	Pp1-sg--n-n	1
mlu	jä	Pp1-si--n-n	1
mlé	jä	Pp1-sl--n-n	1
ja	jä	Pp1-sn--n-n	1
ja	jä	Pp1-sn--y-n	1
vi	vï	Pp2-dn--y-n	1
uvas	vï	Pp2-pa--n-n	1
uvas	vï	Pp2-pa--y-n	1
uvan	vï	Pp2-pd--n-n	1
vam	vï	Pp2-pd--y-n	3
uvan	vï	Pp2-pd--y-n	3
uam	vï	Pp2-pd--y-n	3
uvas	vï	Pp2-pg--n-n	2
uas	vï	Pp2-pg--n-n	2
vami	vï	Pp2-pi--n-n	3
uvami	vï	Pp2-pi--n-n	3
uami	vï	Pp2-pi--n-n	3
Vi	vï	Pp2-pn--n-n	2
vi	vï	Pp2-pn--n-n	2
vi	vï	Pp2-pn--y-n	1
te	tï	Pp2-sa--b-n	1
tè	tï	Pp2-sa--y-n	2
te	tï	Pp2-sa--y-n	2
tobe	tï	Pp2-sd--n-n	2
tabe	tï	Pp2-sd--n-n	2
ti	tï	Pp2-sd--y-n	1
te	tï	Pp2-sg--y-n	1
taêbô	tï	Pp2-si--n-n	1
tí	tï	Pp2-sn--n-n	2
ti	tï	Pp2-sn--n-n	2
ti	tï	Pp2-sn--y-n	1
njima	un	Pp3-dd--n-n	1
jima	un	Pp3-dd--y-n	1
njima	un	Pp3-di--n-n	1
gne	un	Pp3-pa--b-n	1
je	un	Pp3-pa--y-n	2
ih	un	Pp3-pa--y-n	2
gnín	un	Pp3-pd--n-n	1
in	un	Pp3-pd--y-n	2
im	un	Pp3-pd--y-n	2
j́i	un	Pp3-pg--y-n	1
njïmi	un	Pp3-pi--n-n	3
njimi	un	Pp3-pi--n-n	3
gnimi	un	Pp3-pi--n-n	3
onè	un	Pp3fpn--n-n	1
ni	un	Pp3fpn--y-n	2
ne	un	Pp3fpn--y-n	2
jo	un	Pp3fsa--y-n	3
ió	un	Pp3fsa--y-n	3
io	un	Pp3fsa--y-n	3
gniei	un	Pp3fsd--n-n	1
ji	un	Pp3fsd--y-n	1
je	un	Pp3fsg--y-n	1
gniei	un	Pp3fsl--n-n	1
Onà	un	Pp3fsn--n-n	1
Na	un	Pp3fsn--y-n	2
na	un	Pp3fsn--y-n	2
onadva	un	Pp3mdn--n-n	2
ona_dua	un	Pp3mdn--n-n	2
na	un	Pp3mdn--y-n	1
Ni	un	Pp3mpn--y-n	2
ni	un	Pp3mpn--y-n	2
gnega	un	Pp3msa--b-n-y	1
gnega	un	Pp3msa--n-n-y	2
gnagá	un	Pp3msa--n-n-y	2
j́i	un	Pp3msa--y-n-n	2
je	un	Pp3msa--y-n-n	2
ha	un	Pp3msa--y-n-y	2
ga	un	Pp3msa--y-n-y	2
gnimu	un	Pp3msd--n-n	1
mu	un	Pp3msd--y-n	1
njeha	un	Pp3msg--n-n	2
g_nagn	un	Pp3msg--n-n	2
ha	un	Pp3msg--y-n	1
njemu	un	Pp3msl--n-n	2
gnemu	un	Pp3msl--n-n	2
uun	un	Pp3msn--n-n	3
uon	un	Pp3msn--n-n	3
Un	un	Pp3msn--n-n	3
’n	un	Pp3msn--y-n	3
a	un	Pp3msn--y-n	3
an	un	Pp3msn--y-n	3
ga	un	Pp3nsa--y-n-y	1
to	to	Pp3nsn--y-n	1
ko	koj	Pq---a----n	3
Coj	koj	Pq---a----n	3
coga	du	Pq---a----n	3
koj	koj	Pq---n----n	2
Du	du	Pq---n----n	2
chire	kiri	Pq-fpn----n	1
chirj	kiri	Pq-fsl----a	1
Kíra	kiri	Pq-fsn----a	1
chira	kiri	Pq-fsn----n	1
Kaki	kak	Pq-mpn----n	2
Chiri	kiri	Pq-mpn----n	2
Kíri	kiri	Pq-msn----n	1
kir	kir	Pr--------n	3
ke	ka	Pr--------n	3
ch’	ka	Pr--------n	3
koja	koji	Pr-fsn----a	1
naju	naju	Ps1---d---a	1
nasho	näš	Ps1fsap---a	1
mo	möj	Ps1fsas---a	1
mej	möj	Ps1fsds---a	1
naszey	näš	Ps1fsgp---a	2
nashe	näš	Ps1fsgp---a	2
me	möj	Ps1fsgs---a	1
nasha	näš	Ps1fsnp---a	1
Ma	möj	Ps1fsns---a	2
ma	möj	Ps1fsns---a	2
nasze	näš	Ps1mpap---a	3
náshe	näš	Ps1mpap---a	3
nashe	näš	Ps1mpap---a	3
Naszy	näš	Ps1mpdp---a	2
nashin	näš	Ps1mpdp---a	2
nasih	näš	Ps1mpgp---a	1
naših	näš	Ps1mpgp---n	1
memi	möj	Ps1mpis---a	1
naši	näš	Ps1mpnp---a	2
nasi	näš	Ps1mpnp---a	2
muij	möj	Ps1mpns---a	2
moi	muj	Ps1mpns---a	2
nasz	näš	Ps1msap---a-n	2
nash	näš	Ps1msap---a-n	2
naszaha	näš	Ps1msap---a-y	2
nashaha	näš	Ps1msap---a-y	2
miha	möj	Ps1msas---a-y	1
mimu	möj	Ps1msds---a	1
nassega	näš	Ps1msgp---a	2
nashaha	näš	Ps1msgp---a	2
miga	möj	Ps1msgs---a	1
nasz	näš	Ps1msnp---a	3
nash	näš	Ps1msnp---a	3
nas’h	näš	Ps1msnp---a	3
moj	möj	Ps1msns---a	2
moi	möj	Ps1msns---a	2
mo	möj	Ps1nsas---a-n	1
mo	möj	Ps1nsns---a	1
mó	möj	Ps1nsns---n	1
uvasho	wäš	Ps2fsip---a	1
uvaſsi	wäš	Ps2fslp---a	1
wasza	wäš	Ps2fsnp---a	2
uvasha	wäš	Ps2fsnp---a	2
uvashin	wäš	Ps2mpdp---a	1
tvíga	twöj	Ps2msas---a-y	2
tiviga	twöj	Ps2msas---a-y	2
waszaha	wäš	Ps2msgp---a	2
uvashaha	wäš	Ps2msgp---a	2
vaš	wäš	Ps2msnp---a	2
uas	wäš	Ps2msnp---a	2
tuvoi	twöj	Ps2msns---a	3
tuói	twöj	Ps2msns---a	3
tuoi	twöj	Ps2msns---a	3
uvashe	wäš	Ps2npap---a	2
uase	wäš	Ps2npap---a	2
trivin	twöj	Ps2nsis---a	1
wasze	wäš	Ps2nsnp---a	3
uvashe	wäš	Ps2nsnp---a	3
uase	wäš	Ps2nsnp---a	3
tuö	twöj	Ps2nsns---n	1
nju	njü	Ps3---d---a	1
gnih	njeh	Ps3---p---a	1
Njì	nji	Ps3---sf--a	3
nji	nji	Ps3---sf--a	3
gni	nji	Ps3---sf--a	3
njeha	njagä	Ps3---sm--a	3
njà	njagä	Ps3---sm--a	3
njagä	njagä	Ps3---sm--a	3
si	si	Px------y	2
se	se	Px------y	2
sebe	sabe	Px---a--npn	1
si	sabe	Px---d--ypn	1
sabò	se	Px---i--npn	1
sve	swöj	Px-mpa---sa	1
nikar	nikar	Pz---a----n	2
nicar	nikar	Pz---a----n	2
ni_kógor	nišći	Pz---g----n	1
nisgi	nišći	Pz---n----n	3
nisçhí	nišći	Pz---n----n	3
nikar	nikar	Pz---n----n	3
ninega	nidan	Pz-msg----n	1
ninega	nidan	Pz-nsg----a	1
pa	pa	Q	3
ni	ni	Q	3
dret	drët	Q	3
vec	već	Rgc	3
vagh	već	Rgc	3
bo	bö	Rgc	3
itu	ito	Rgp	3
dolu	dölu	Rgp	3
damuw	damu	Rgp	3
nejveć	najveć	Rgs	2
nej_već	najveć	Rgs	2
tou	tuw	Spc	3
tàpot	tapod	Spc	3
ta_pod	tapod	Spc	3
tau	tuw	Spca	2
tana	tana	Spca	2
ta	tah	Spcd	3
taper	tapar	Spcd	3
ta_h	tah	Spcd	3
taprit	taprid	Spcg	3
ses_med	zizmid	Spcg	3
sauvojo	zawojo	Spcg	3
tapod	tapod	Spci	3
ta-mi	tamid	Spci	3
ta_mej	tami	Spci	3
Tuw	tuw	Spcl	3
tuv	tuw	Spcl	3
tau	tuw	Spcl	3
Za	za	Sps	3
za	za	Sps	3
dardu	dardu	Sps	3
w	w	Spsa	3
v	w	Spsa	3
na	na	Spsa	3
per	par	Spsd	2
h	h	Spsd	2
od	od	Spsg	1
zis	ziz	Spsi	3
s	z	Spsi	3
prid	prid	Spsi	3
po	po	Spsl	3
par	par	Spsl	3
na	na	Spsl	3
ot	od	Spsn	2
na	na	Spsn	2
tè	te	Tffpa	2
te	te	Tffpa	2
tih	te	Tffpg	2
te	te	Tffpg	2
temi	te	Tffpi	1
Te	te	Tffpn	2
te	te	Tffpn	2
to	te	Tffsa	1
tè	te	Tffsg	2
te	te	Tffsg	2
to	te	Tffsi	1
tì	te	Tffsl	3
ti	te	Tffsl	3
tey	te	Tffsl	3
Ta	te	Tffsn	2
ta	te	Tffsn	2
Tè	te	Tfmdn	1
tè	te	Tfmpa	2
te	te	Tfmpa	2
tin	te	Tfmpd	2
tim	te	Tfmpd	2
tih	te	Tfmpg	2
teh	te	Tfmpg	2
Ti	te	Tfmpn	2
ti	te	Tfmpn	2
te	te	Tfmsa-n	1
tomu	te	Tfmsd	1
taga	te	Tfmsg	2
itoga	te	Tfmsg	2
tin	te	Tfmsl	1
Te	te	Tfmsn	2
te	te	Tfmsn	2
te	te	Tfnpa	1
tih	te	Tfnpl	1
tö	te	Tfnsa-n	2
to	te	Tfnsa-n	2
toga	te	Tfnsa-y	1
ti	te	Tfnsl	1
no	dan	Tifsa	1
nì	dan	Tifsd	2
ni	dan	Tifsd	2
nò	dan	Tifsi	1
nì	dan	Tifsl	2
ni	dan	Tifsl	2
na	dan	Tifsn	1
na	dan	Timpa	1
dni	dan	Timpn	1
den	dan	Timsa-n	2
dan	dan	Timsa-n	2
noga	dan	Timsa-y	3
nagha	dan	Timsa-y	3
dnaha	dan	Timsa-y	3
noga	dan	Timsg	3
naha	dan	Timsg	3
naga	dan	Timsg	3
dnin	dan	Timsl	1
dan	dan	Timsn	1
ne	dan	Tinpa	1
no	dan	Tinsa-n	1
dneha	dan	Tinsg	1
bě	bet	Vaia3s--------p	2
bè	bet	Vaia3s--------p	2
bon	bet	Vaif1s--------p	2
bom	bet	Vaif1s--------p	2
bota	bet	Vaif2p--n-----pn	1
bo	bet	Vaif3s--------p	1
beše	bet	Vaii3s--------p	2
bese	bet	Vaii3s--------p	2
sowa	bet	Vaip1d--n-----p	1
tiemo	tët	Vaip1p--n-----p	2
sömö	bet	Vaip1p--n-----p	2
si	bet	Vaip1s--n-----p	2
giò	tët	Vaip1s--n-----p	2
ste	bet	Vaip2p--n-----py	1
si	bet	Vaip2s--n-----p	1
nisi	bet	Vaip2s--y-----p	1
sta	bet	Vaip3d--n-----p	1
so	bet	Vaip3p--n-----p	1
niso	bet	Vaip3p--y-----p	2
ni_so	bet	Vaip3p--y-----p	2
je	bet	Vaip3s--n-----p	1
ni	bet	Vaip3s--y-----p	1
biti	bet	Van-----------p	2
bit	bet	Van-----------p	2
bile	bet	Vaps-pfa------p	1
bili	bet	Vaps-pma------p	1
Bila	bet	Vaps-sfa------p	2
bila	bet	Vaps-sfa------p	2
byl	bet	Vaps-sma------p	2
bil	bet	Vaps-sma------p	2
bilo	bet	Vaps-sna------p	1
bodite	bet	Vasp2p--------py	2
bodete	bet	Vasp2p--------py	2
bodi	bet	Vasp3s--------p	2
Bode	bet	Vasp3s--------p	2
bé	bet	Vcia3s--------p	1
bého	bet	Vcii3p--------p	1
mese	mët	Vcii3s--------p	3
běše	bet	Vcii3s--------p	3
bese	bet	Vcii3s--------p	3
si	bet	Vcip1s--n-----p	3
se	bet	Vcip1s--n-----p	3
man	mët	Vcip1s--n-----p	3
nisi	bet	Vcip1s--y-----p	1
sta	bet	Vcip2d--n-----p	1
mata	mët	Vcip2p--n-----pn	1
stö	bet	Vcip2p--n-----py	2
stè	bet	Vcip2p--n-----py	2
si	bet	Vcip2s--n-----p	1
sò	bet	Vcip3p--n-----p	2
so	bet	Vcip3p--n-----p	2
nimaio	mët	Vcip3p--y-----p	1
ostane	ostät	Vcip3s--n-----e	1
ma	bet	Vcip3s--n-----p	2
je	bet	Vcip3s--n-----p	2
ní	bet	Vcip3s--y-----p	2
ni	bet	Vcip3s--y-----p	2
teita	tët	Vcmp2p--------pn	1
biti	bet	Vcn-----------p	3
bit	bet	Vcn-----------p	3
bet	bet	Vcn-----------p	3
mele	mët	Vcps-pfa------p	2
bile	bet	Vcps-pfa------p	2
bili	bet	Vcps-pma------p	1
méla	mët	Vcps-sfa------p	2
bila	bet	Vcps-sfa------p	2
mel	mët	Vcps-sma------p	3
biu	bet	Vcps-sma------p	3
bil	bet	Vcps-sma------p	3
bilu	bet	Vcps-sna------p	2
bilo	bet	Vcps-sna------p	2
bodi	bet	Vcsp3s--------p	2
bodê	bet	Vcsp3s--------p	2
povi	puvet	Vmia3s--n-----e	2
nalese	nalëst	Vmia3s--n-----e	2
idu	tet	Vmia3s--n-----p	1
bo	bet	Vmif3s--------p	1
nadivahamo	nadivat	Vmii1p--------p	1
poznahata	poznät	Vmii3d--------e	1
pravijahata	pravit	Vmii3d--------p	3
prašávahata	pravit	Vmii3d--------p	3
hardéhata	tet	Vmii3d--------p	3
pravijaho	pravit	Vmii3p--------p	3
herdého	tet	Vmii3p--------p	3
daržaho	däržat	Vmii3p--------p	3
bramase	bramät	Vmii3s--------e	1
romonjaše	rumunet	Vmii3s--------p	3
hardéše	tet	Vmii3s--------p	3
bramase	bramät	Vmii3s--------p	3
uvsdahujamo	wzdahüwat	Vmip1p--n-----p	3
odpuštjúvamo	utpušćüwat	Vmip1p--n-----p	3
odposgiúomo	utpušćüwat	Vmip1p--n-----p	3
servian	sarvijät	Vmip1s--------e	1
servian	sarvijät	Vmip1s--------p	3
dílan	dëlat	Vmip1s--------p	3
bogan	bogat	Vmip1s--------p	3
raccomandan	rakomandät	Vmip1s--n-----e	3
preponinan	preponinat	Vmip1s--n-----e	3
aman	amät	Vmip1s--n-----e	3
vidim	vïdët	Vmip1s--n-----p	3
verjen	vërwat	Vmip1s--n-----p	3
mislen	mïslit	Vmip1s--n-----p	3
mata	mët	Vmip2d--n-----p	1
intendate	intendät	Vmip2p--n-----en	1
snate	morët	Vmip2p--n-----pn	3
pošlišata	pušlüšat	Vmip2p--n-----pn	3
intendate	intendät	Vmip2p--n-----pn	3
tarpite	tpët	Vmip2p--n-----py	2
datte	dät	Vmip2p--n-----py	2
nimate	mët	Vmip2p--y-----py	1
viš	vëdët	Vmip2s--n-----p	2
tradis	tradet	Vmip2s--n-----p	2
vvesejo	wezat	Vmip3p--n-----e	3
uvmarjo	wmrit	Vmip3p--n-----e	3
slizejo	slić	Vmip3p--n-----e	3
vijo	vëdët	Vmip3p--n-----p	3
saliuajo	zalïwat	Vmip3p--n-----p	3
boijo	bat	Vmip3p--n-----p	3
pride	prït	Vmip3s--n-----e	3
objoče	objökat	Vmip3s--n-----e	3
nalíse	nalëst	Vmip3s--n-----e	3
živi	žïvit	Vmip3s--n-----p	3
kliče	klïcat	Vmip3s--n-----p	3
klíce	klïcat	Vmip3s--n-----p	3
Ni	bet	Vmip3s--y-----p	2
ni	bet	Vmip3s--y-----p	2
Pinsajmo	pinsät	Vmmp1p--------e	3
contemplaimo	kontemplät	Vmmp1p--------e	3
accompagnaimu	akompanjät	Vmmp1p--------e	3
vassaléimo	vasalët	Vmmp1p--------p	3
gauò	tet	Vmmp1p--------p	3
gauo	tet	Vmmp1p--------p	3
Usamite	wzet	Vmmp2p--------en	3
poite	pujtet	Vmmp2p--------en	3
Parnisijta	parnistet	Vmmp2p--------en	3
wybronite	vibranit	Vmmp2p--------ey	3
hovarnajte	govarnät	Vmmp2p--------ey	3
Dáite	dät	Vmmp2p--------ey	3
Zuite	čot	Vmmp2p--------pn	3
Tastá	tet	Vmmp2p--------pn	3
amaite	amät	Vmmp2p--------pn	3
Ricite	rićet	Vmmp2p--------py	3
prosite	pruset	Vmmp2p--------py	3
hovarnajte	govarnät	Vmmp2p--------py	3
usami	wzet	Vmmp2s--------e	3
Ostani	ostät	Vmmp2s--------e	3
hrishi	grišit	Vmmp2s--------e	3
vidi	vïdët	Vmmp2s--------p	3
Verij	vërwat	Vmmp2s--------p	3
lashi	lägat	Vmmp2s--------p	3
vikupit	viküpit	Vmn-----------e	3
Spovedat	spovëdat	Vmn-----------e	3
prabet	pribet	Vmn-----------e	3
videt	vïdët	Vmn-----------p	3
veruat	vërwat	Vmn-----------p	3
meritat	maratät	Vmn-----------p	3
dilaiog	dëlat	Vmp----a------p	1
nárit	naredit	Vmp----p------e	1
zdjilana	zdëlat	Vmp--sfp------e	3
sdìllana	zdëlat	Vmp--sfp------e	3
banaden	binidet	Vmp--sfp------e	3
nashanà	nistet	Vmp--sfp------p	1
svesan	zvezat	Vmp--smp------e	3
ghian	ǵat	Vmp--smp------e	3
coronana	koronät	Vmp--smp------e	3
crisan	krïžat	Vmp--smp------p	3
coronana	koronät	Vmp--smp------p	3
bit	bet	Vmp--smp------p	3
sdilano	zdëlat	Vmp--snp------e	3
paragionu	paraćät	Vmp--snp------e	3
comsumano	konsumät	Vmp--snp------e	3
mële	mët	Vmps-dfa------p	1
ustala	wstät	Vmps-dma------e	3
poznala	poznät	Vmps-dma------e	3
parsilila	parsïlit	Vmps-dma------e	3
rekla	rićet	Vmps-dma------p	2
poznala	poznät	Vmps-dma------p	2
sdelale	zdëlat	Vmps-pfa------e	3
paršle	prït	Vmps-pfa------e	3
dorivale	durivät	Vmps-pfa------e	3
videle	vïdët	Vmps-pfa------p	3
šlè	tet	Vmps-pfa------p	3
prajale	prihajat	Vmps-pfa------p	3
umorili	umuret	Vmps-pma------e	3
pródali	prodät	Vmps-pma------e	3
pozali	počnet	Vmps-pma------e	3
vedle	vëdët	Vmps-pma------p	3
šli	tet	Vmps-pma------p	3
blíshghnili	blïžnjit	Vmps-pma------p	3
odparle	udprit	Vmps-pna------e	1
succedenala	sucëdinat	Vmps-sfa------e	3
omužila	umužet	Vmps-sfa------e	3
benedila	binidet	Vmps-sfa------e	3
delala	dëlat	Vmps-sfa------p	3
clizala	klïcat	Vmps-sfa------p	3
bohala	bogat	Vmps-sfa------p	3
vilisou	vilëst	Vmps-sma------e	3
snídal	snëst	Vmps-sma------e	3
parbližal	parblïžat	Vmps-sma------e	3
rékal	rićet	Vmps-sma------p	3
rekal	rićet	Vmps-sma------p	3
murgniulou	murnjulät	Vmps-sma------p	3
sdělalo	zdëlat	Vmps-sna------e	3
sdelalo	zdëlat	Vmps-sna------e	3
pashló	prït	Vmps-sna------e	3
gorelo	gorët	Vmps-sna------p	2
delalo	dëlat	Vmps-sna------p	2
serviaj	sarvijät	Vmsp1s--------e	2
amai	amät	Vmsp1s--------e	2
uvshivaj	wžïwat	Vmsp1s--------p	3
snaj	znät	Vmsp1s--------p	3
amai	amät	Vmsp1s--------p	3
Prydy	prït	Vmsp3s--------e	3
pride	prït	Vmsp3s--------e	3
pidè	pujtet	Vmsp3s--------e	3
spat	spät	Vmu-----------p	1
téshe	tët	Voii3s--------p	3
tese	tët	Voii3s--------p	3
méše	mët	Voii3s--------p	3
mamö	mët	Voip1p--n-----p	1
moren	morët	Voip1s--n-----p	3
morem	morët	Voip1s--n-----p	3
cion	tët	Voip1s--n-----p	3
morete	morët	Voip2p--n-----pn	2
morata	bet	Voip2p--n-----pn	2
Ciete	tët	Voip2p--n-----py	1
mores	morët	Voip2s--n-----p	1
nimajo	mët	Voip3p--y-----p	1
more	morët	Voip3s--n-----p	2
Marà	marat	Voip3s--n-----p	2
moret	morët	Von-----------p	1
mele	mët	Vops-pfa------p	1
mugle	morët	Vops-pma------p	1
smela	smët	Vops-sfa------p	2
mela	mët	Vops-sfa------p	2
teu	tët	Vops-sma------p	3
tel	tët	Vops-sma------p	3
mogal	morët	Vops-sma------p	3
s	s	X	4
i	i	X	4
din	din	X	4
2+2=5	2+2=5	X	4
s	s	Y	2
R	r	Y	2
)	)	Z	10
(	(	Z	10
"	"	Z	10
.	.	Z	10
..	..	Z	10
